R 10000 10000
NO ./texture/nord.xpm
SO ./texture/sud.xpm
WE ./texture/nord.xpm
EA ./texture/sud.xpm
S ./texture/pig.xpm
F 28,100,0
C 88,185,200

        1111111111111111111111111
        1000000000110000000000001
        1011000001110000000000001
       10010000000000000000000001
111111111011000001110000000222221
100000000011000001110111111111111
11110111111111011100000010S01111
11110111111111011101010010001111
11000000110101011100000010001111
10002000000000001100000010101
10000000000000001101010010001
110000011101010111011111100111
11110111 1110101 100000000001
11111111 1111111 111111111111


