R 1000000000 1000000000
NO ./texture/nord.xpm
SO ./texture/sud.xpm
WE ./texture/nord.xpm
EA ./texture/sud.xpm
S ./texture/sprite
F 28,100,0
C 88,185,200

11111111111111111111
11000000000000000011
11000000000000000011
11001111000011110011
11001111000011110011
11000000111100000011
11000011111111000011
11000011111111000011
11000011000011000011
11000000000000000011
11000000000000000011
11000000000000000011
11000000000000000011
11001111000011110011
11001111000011110011
11000000111100000011
11000011111111000011
1100N011111111000011
11000011000011000011
11111111111111111111

