R 1920 1080
NO ./texture/nord
SO ./texture/sud
WE ./texture/ouest
EA ./texture/est
S ./texture/sprite
F 28,100,0
C 88,185,200



        1111111111111111111111111
        1000000000110000000000001
        1011000001110000002000001
        1001000000000000000000001
111111111011000001110000000000001
100000000011000001110111111111111
11110111111111011100000010001
11110111111111011101010010001
11000000110101011100000010001
10002000000000001100000010101
10000000000000001101010010001
11000001110101011101111110W0111
11110111 1110101 100000000001
11111111 1111111 11111111111
