
R 1270 720
NO ./texture/nord.xpm
SO ./texture/sud.xpm
WE ./texture/gauche.xpm
EA ./texture/droite.xpm
S ./texture/chest.xpm

F 150,0,50
C 88,185,200

1111111111111
10000000000001
1000000000S001
10000000000001
10000000000001
10000000000001
10000000000001
10000000000001
10000000000001
10000000000001
10000000000001
11111111111111