R 1270 720
NO ./texture/nord.xpm
SO ./texture/sud.xpm
WE ./texture/gauche.xpm
EA ./texture/droite.xpm
S ./texture/sprite
F 28,100,0
C 88,185,200


   1111111
   100S001
   1000001
   1000001
   1000001
   1000001
   1000001
   1000001
   1000001
   1000001
   1000001
   1000001
   1001001
   1001001
   1101011
     111
