R 1280 720
NO ./texture/nord
SO ./texture/sud
WE ./texture/ouest
EA ./texture/est
S ./texture/sprite
F 28,100,0
C 225,30,0






        1111111111111111111111111
        1000000000110000000000001
        1011000001110000002000001
       1001000000000000000000001
111111111011000001110000000000001
100000000011000001110111111111111
1111011111111101110000001000111111111111111111111
11110111111111011101010010001111111111111111111101
110000001101010111000000100011111111            1
10002000000000001100N00010001
10000000000000001101010010001
110000011101010111110111100111
11110111 1110101 101111010001
11111111 1111111 111111111111







 11
1021
 11