R 1280 720
NO ./texture/nord.png
SO ./texture/sud.png
WE ./texture/gauche.png
EA ./texture/droite.png
S ./texture/sprite
F 28,100,0
C 88,185,200



11111   11111
10001   10001
10001   10001
10001   10001
11111   11111
   1111111
   100S001
   1000001
   1000001
   1000001
   1000001
   1000001
   1000001
   1000001
   1000001
   1000001
   1000001
   1001001
   1001001
   1101011
    11111
