
R 1270 720
NO ./texture/nord.xpm
SO ./texture/nord.xpm
WE ./texture/nord.xpm
EA ./texture/nord.xpm
S ./texture/chest.xpm

F 150,0,50
C 88,185,200

1111111111111
100002000000011111
1112000000W001
1000000000111111111
10000000000011111001
11111111111111111111




