R 1920 1080
NO ./texture/nord.xpm
SO ./texture/nord.xpm
WE ./texture/nord.xpm
EA ./texture/nord.xpm
S ./texture/chest.xpm
F 28,100,0
C 88,185,200

1111111111111
100000000000011111  
11100000000001    
10000000000111111111
10000000000011111001      
10000000000011111111111111111111111111        
10000000000000000000000000000000111111111  
100000000000000000000000000000000011111
10000000000011111111111111111111111111  
1000000000000111
10000000000000011111
10000000000000011111111111111111
111111000000001111110000000000011111111111111111111111111  
1000000000000000000000000000000000001111100011111 111
10000000S000000000000020110000010000111111000000111111111111111111111111111111111111111111111
1000000000000000000000000000000000000000000000000000000001111111111111111111111111111111111111111111
100000000000011111000000010000011001111001110000000111111111111111111111111111111111111111111111111111
100000000000000000000000000000000000000000000000000000000000000000000000000000000000011
10000000000000011111100000001000000011100001110000110000001111111111111111111111111111111111111111111111
100000000000000000000000000000000000000000000000000000000000000000000000000000000000111111
100000000000000111111111111111111111111111111111111111111111111111111111111111111111111111111111111111111111111
1111000000011111111      
10000000000000011111
100000000000000111
10000000000000011111
100000000000000111111111111111111111111  
100000000000000000000011111
10000000000011111111111111111111111111  
1000000000000111
10000000000000011111
100000000000000111
1111111111111111




