
NO ./texture/nord.xpm
SO ./texture/nord.xpm
WE ./texture/nord.xpm
EA ./texture/nord.xpm
R 1920 1080
F 28,100,0
R 1920 1080
C 88,185,200

1111111111111
100000000000011111  
11100000000001 
100S0000000111111111
10000000000011111001     
11111111111111111111




