

R      1920     1080
NO ./texture/nord
SO ./texture/sud

WE ./texture/ouest
EA ./texture/est
S ./texture/sprite
F 220,100,20


C 225,30,2




111111111111
11011N000001
110000000001
110000000001
110000000001
111111111111



